startservers	Resource
mod_proxy_balancer.timeout	NONE
ProxyErrorOverride	Function
virtualhost	Function
-g	Function
-fprefetch-loop-arrays	Function
-O3	Optimization
-flto	Optimization
-O0	Optimization
-O1	Optimization
-O2	Optimization
-Ofast	Tradeoff
-fbounds-check	Function
-finline-functions	Function
-fno-devirtualize	Optimization
-mdisable-fpregs	Function
-Wsequence-point	Function
-Os	Optimization
-fno-inline	Function
-fsanitize	Tradeoff
-O	Optimization
query_cache_size	Resource
index_merge	Optimization
max_recursive_iterations	Resource
--log-slave-updates	Function
join_cache_level	Optimization
innodb_buffer_pool_size	Resource
delay_key_write	Optimization
innodb_sort_buffer_size	Resource
lower_case_table_names	NONE
sort_buffer_size	Resource
read_buffer_size	Resource
query_cache_type	NONE
innodb_file_per_table	NONE
innodb_log_file_size	Tradeoff
innodb_fill_factor	Resource
innodb_flush_log_at_trx_commit	Tradeoff
skip-thread-priority	Optimization
innodb_adaptive_hash_index	Optimization
innodb_flush_method	Function
innodb_change_buffering	Optimization
relay_log_recovery	Function
storage_engine	NONE
checkpoint	NONE
binlog_format	NONE
sync_binlog	Function
old_alter_table	Function
innodb_stats_persistent	Function
optimizer_switch	Function
index_merge	Optimization
performance_schema	Optimization
foreign_key_checks	Function
sslverifydepth	Tradeoff